Xoi, Xoi, Xoi, Xoi, Xoi, Xoi, Xoi, Xoi, Xuc, Xuc, Xoi, Xoi, Xoi, Xoi, Xoi, Xoi, Xoi, Xoi, Xoi, Xoi, Xu, Xu, Xu, Xu, Xu, Xu, Xu, Xu, Xu, Xu, Xu, Xu, Qxua, Qxua, Qxua, Qxua, Xu, Xu, Xu
Xoi, Xoi, Xos, Xos, Xos, Xos, Xuc, Xuc, Urc, Xuc, Xuc, Xoi, Xoi, Xos, Xos, Xos, Xos, Xos, Xos, Xos, Xu, Xu, Xu, Xu, Xu, Xu, Xu, Xu, Xu, Xu, Xu, Xu, Xu, Qxua, Qxua, Xu, Xu, Xu, Xu
Xoi, Xoi, Xos, Xos, Xuc, Xoi, Urc, Qxu, Xuc^Efs, Iwo, Iwo, Xuc, Xuc, Xoi, Xos, Xos, Xos, Xos, Xos, Xos, Xu, Xu, Xu, Xu, Xu, Xu, Xu, Xu, Xu, Xu, Qxua, Xu, Xu, Xu, Qxua, Xu, Xu, Xu, Xu
Xu, Xoi, Xuc, Xuc, Urc, Xuc, Xuc^Efs, Qxu, Qxu, Iwo, Xuc, Qxu, Urc, Xuc, Xoi, Xoi, Xoi, Xos, Xos, Xos, Xos, Xu, Xue, Xu, Xu, Xu, Xu, Qxua, Qxua, Qxua, Qxua, Xu, Qxua, Qxua, Xu, Xu, Xu, Xu, Xu
Xu, Xuc, Urc, Xuc, Xuc^Efs, Iwo, Iwo, Qxu, Xuc, Iwo, Urc, Qxu, Xuc, Xuc, Xoi, Xoi, Xoi, Xos, Xos, Xos, Xos, Xue, Xue, Xu, Xue, Xu, Xu, Xu, Qxua, Qxua, Xu, Qxua, Qxua, Qxua, Xu, Xu, Xue, Xu, Qxua
Qxu, Qxu, Xuc, Iwo, Iwo, Iwo, Xuc, Qxu, Qxu, Xuc, Xuc, Xuc, Xoi, Xos, Xos, Xoi, Xos, Xos, Xos, Xos, Xos, Xue, Xue, Xue, Xue, Xu, Xu, Xu, Qxua, Xu, Qxua, Qxua, Gll, Qxua, Qxua, Qxua, Xu, Qxua, Xu
Xur, Qxu, Iwo, Iwo, Iwo, Iwr, Iwr, Xuc, Xuc^Efs, Xuc, Xoi, Xoi, Xos, Xoi, Xos, Xos, Xos, Xu, Xos, Xos, Xu, Xu, Xue, Xue, Qxua, Qxua, Iwo, Iwo, Xu, Xu, Qxua, Qxua, Qxua, Qxua, Qxua, Qxua, Qxua, Qxua, Xu
Xur, Qxu, Qxu, Qxu, Iwo, Xuc, Xuc, Iwr, Iwr, Xuc, Xuc, Xos, Isa^Qhh, Xos^Efs, Isa^Qhh, Isa^Qhh, Isa^Qhh, Xos^Efs, Isa^Qhh, Xos, Xos, Xos, Qxua, Qxua, Qxua, Qxua, Qxua, Xu, Xu, Xu, Gll, Qxua, Qxua, Qxua, Gll, Qxua, Xu, Xu, Xu
Qxu, Qxu, Qxu, Xuc, Urc, Xuc, Xoi, Xuc, Xoi, Rr^Pr/, Isa^Qhh, Isa^Qhh, Urc^Vhcr, Isa^Qhh, Urc, Urc, Urc, Isa^Qhh, Urc^Vhcr, Isa^Qhh, Isa^Qhh, Qxua, Qxua, Qxua, Qxua, Qxua, Qxua, Qxua, Xu, Xu, Gll, Qxua, Qxua, Gll, Qxua, Qxua, Xu, Xu, Xu
Qxu, Xu, Xu, Xuc, Xuc, Xoi, Xoi, Xoi, Isa^Qhh, Isa^Qhh, Isa, Isa, Wwf, Wwrg, Wwrg, Cud, Cud, Urc, Wwf, Isa^_mhh, Isa, Isa^Qhh, Isa^Qhh, Qxua, Qxua, Qxua, Xue, Qxua, Xu, Xu, Qxua, Qxua, Qxua, Qxua, Qxua, Qxua, Xu, Xu, Xu
Qxu, Xu, Xoi, Xuc, Xoi, Xoi, Urb, Rr^Pr\o, Xos, Isa^Qhh, Isa^Eb, Wwf, Urc^Edt, Urc^Eb, Cud^Edt, 1 Kud, Cud, Urc^Eb, Urc, Wwf, Isa^Eb, Isa, Isa^Qhh, Qxua, Xoc, Xue, Xoi, Xue, Xu, Xu, Xu, Qxua, Qxua, Qxua, Gll, Xu, Xu, Xu, Xu
Xu, Xu, Xoi, Xoi, Xoi, Urb, Xoi, Urb, Xos, Isa^Qhh, Isa, Wwf, Urc^Dr, Urc^Edt, Urc^Edt, Cud^Edt, Urc, Urc, Urc^Vhcr, Wwf, Isa^Edt, Isa^Edt, Isa^Qhh, Xoc, Xoi, Xoi, Xoi, Xu, Qxua, Xu, Qxua, Qxua, Qxua, Gll, Xu, Xu, Xu, Xu, Xu
Xoi, Xoi, Xoi, Xuc, Xuc, Urb, Xoi, Urb, Xos, Isa^Qhh, Isa^Qhh, Isa^Qhh, Isa^Qhh, Urc^Qhh, Urc^Qhh, Urc^Qhh, Urc^Qhh, Urc^Qhh, Isa^Qhh, Isa^Qhh, Isa^Qhh, Isa^Qhh, Xoc, Xoc, Xoi, Xoi, Xoi, Xu, Xu, Qxua, Qxua, Qxua, Qxua, Qxua, Qxua, Xu, Qxua, Qxua, Qxua
Xoi, Xoi, Xoi, Xuc, Urb, Urb, Urb, Urb, Xos, Xos^Efs, Isa, Isa, Isa, Xos, Xos^Efs, Xos, Xos^Efs, Xos, Isa, Isa, Isa, Xos^Efs, Xos, Xoc, Xoi, Xoi, Xoi, Xoi, Xu, Xu, Gll, Qxua, Qxua, Xu, Xu, Qxua, Xu, Xu, Xu
Xoi, Xoi, Xoi, Xuc, Urb, Xuc, Urb, Xoi, Xos, Tb^Tf, Uu, Uu, Uu, Isa, Urb, Uu^Eb, Urb^Edb, Isa, Uu, Uu, Uu, Tb^Tf, Xos, Xoi, Xoi, Xoi, Xoi, Xoi, Xu, Xu, Qxua, Gll, Qxua, Qxua, Xu, Qxua, Qxua, Xu, Xu
Xoi, Xoi, Xoi, Xuc, Urb, Xuc, Urb, Xuc, Qxu, Tb^Tf, Qxu, Qxu, Qxu, Ur, Urb, Uu^Dr, Urb^Edb, Ur^Edb, Qxu, Qxu, Uu, Tb^Tf, Xos, Xoi, Xoi, Xoi, Xoi, Xoi, Xu, Qxua, Qxua, Qxua, Qxua, Qxua, Xu, Xu, Xu, Xu, Xu
Xoi, Xoi, Xoi, Xuc, Xuc, Urb, Xuc, Urb, Xuc, Qxu, Uu^Dr, Qxu, Uu, Ur, Uh, Uu^Dr, Xos, Ur, Uu^Edt, Qxu, Uu, Tb^Tf, Xos, Xoi, Xoa, Xoi, Xoi, Xu, Xu, Qxua, Qxua, Qxua, Qxua, Qxua, Xu, Xu, Xu, Xu, Xu
Xoi, Xoi, Xoi, Xoi, Xuc, Urb, Xuc, Urb, Xuc, Xos, Uu^Vud, Uu, Isa, Ur, Xur, Uu^Dr, Xos, Ur^Edt, Isa^Edt, Uu, Uu^Vud, Xos, Xoa, Xoa, Iwo, Xoa, Xoa, Xu, Xu, Xu, Qxua, Qxua, Gll, Gll, Xu, Xu, Xu, Xu, Xu
Xoi, Xoi, Xoi, Xoi, Xuc, Urb, Urb, Urb, Xuc, Xos, Xos, Isa, Isa, Xur, Xos, Xur, Xos, Xos, Isa, Isa, Xos, Xos, Iwo, Iwo, Urc, Iwo, Iwo, Xoa, Xu, Xu, Qxua, Qxua, Qxua, Qxua, Xu, Xu, Xu, Xu, Xu
Xu, Xoi, Xue, Xoi, Xoi, Xos, Xos, Urb, Urb, Xuc, Xos, Isa, Isa^Edb, Xoa, Xoa, Xos, Xos, Xos^Efs, Isa, Isa, Xos, Xos, Iwo, Iwo, Iwo, Iwo, Xos, Xoa, Xu, Xu, Qxua, Qxua, Qxua, Xu, Xu, Xu, Xu, Xu, Xu
Wo, Xu, Xu, Xu, Xu, Xoi, Xoc, Xos, Xos^Efs, Rr^Pr/o, Isa, Isa^Edb, Ur^Edb, Isa, Gll^Fdw, Uu^Eb, Gll^Fdw, Ur, Ur^Edb, Isa^Edb, Isa, Rr^Pr\, Xos^Efs, Xos, Xoc, Xos, Xu, Xu, Xu, Xu, Gd, Xur, Gll, Xu, Xu, Xu, Xu, Xu, Xu
Wo, Wo, Wo, Wo, Wo, Xu, Isa, Xos, Isa, Isa, Isa, Ur^Es, Wog, Wog, Wwg, Gll^Fdw, Wwg, Wwg, Wwg, Isa^Edb, Isa, Isa, Isa, Xos, Isa, Xu, Wo, Wo, Wo, Hhd, Gd, Gll, Gd, Hhd, Xu, Xu, Xu, Xu, Xu
Wo, Wo, Wo, Wo, Wo, Wo, Wo, Isa, Wwg^Bsb\, Wwg^Es, Wwg, Wwg, Wog, Wog, Wog, Wwg^Es, Wwg, Wwg, Wwg^Ewl, Wwg, Wwg, Wwg, Wwg^Dr, Isa, Wo, Wo, Wo, Wo, Wo, Hhd, Gll, Gd^Fetd, Gll, Hhd, Xu, Xu, Xu, Xu, Xu
Xu, Wo, Xu, Xu, Xu, Wo, Uu, Ww, Uu, Ur, Uu, Wwg, Wwg, Wog, Wwg, Gll^Feth, Wwg, Wwg, Wwg, Wwg, Uu^Edb, Ur^Edb, Uu, Ww, Uu, Wo, Xos, Xu, Xu, Hhd, Hhd, Gll, Hhd, Hhd, Xu, Xu, Xu, Xu, Xu
Xoi, Xu, Xoc, Xor, Xoi, Xos, Uu, Uu, Ur^Vud, Ur^Edb, Ur^Edb, Gll^Dr, Gll^Fdw, Wwg, Gll^Fdw, Wwg, Gll^Fdw, Wwg, Gll^Fdw, Gll^Fdw, Ur, Ur^Edb, Ur^Vud, Uu, Uu, Xos, Xor, Xu, Xu, Xu, Xu, Xu, Xu, Xu, Xu, Xu, Xu, Xu, Xu
Xoc, Xoc, Xoc, Xoc, Xos, Xos, Rr^Pr\, Ur, Uu, Uu^Edb, Uu, Ur, Xos^Qhh, Gll^Fdw, Xos^Qhh, Gll^Fdw, Xos^Qhh, Gll^Fdw, Xos^Qhh, Ur, Uu, Uu, Uu, Ur, Rr^Pr/, Xos, Xoc, Xor, Xoi, Xu, Xu, Xu, Xu, Xu, Xu, Xu, Xu, Xu, Xu
Xoc, Xoc, Xoc, Xor, Xos, Iwo, Xos, Xoc, Xos^Qhh, Xos^Qhh, Uu^Qhh, Ur^Qhh, Tb^Tf, Xos^Qhh, Xos^Efs, Xos^Qhh, Xos^Efs, Xos^Qhh, Tb^Tf, Ur^Qhh, Uu^Qhh, Xos^Qhh, Xos^Qhh, Xoc, Xoc, Iwr^_s, Xoc, Xor, Xu, Xu, Xu, Xu, Xu, Xu, Xu, Xu, Xu, Xu, Xu
Xoc, Xoc, Xoc, Xos, Iwo, Iwo, Iwo, Xos, Xos^Qhh, Gll^Fdw, Xos^Efs, Ur, Ur, Tb^Tf, Ur, Ur^Vud, Ur, Tb^Tf, Ur, Ur^Edt, Xos^Efs, Gll^Fdw, Xos^Qhh, Xoc, Xoc, Iwr^_s, Xoc, Xof, Xu, Xu, Xu, Xu, Xu, Xu, Xu, Xu, Xoc, Xu, Xoc
Xoc, Xoc, Xoc, Xos, Iwo, Iwo, Iwo, Xos, Xos^Qhh, Gll^Fdw, Gll^Fdw, Uu, Ur, Ur^Edt, Cud^Edt, Tb^Tfi, Cud, Ur^_mh, Ur, Uu^Edt, Gll^Fdw, Gll^Fdw, Xos^Qhh, Xoc, Xoc, Xoc, Xoc, Xoc, Xu, Xu, Xu, Xu, Xu, Xu, Xu, Xoc, Xoc, Xoc, Xoc
Xoc, Xoc, Xoc, Xos, Iwo, Urc, Iwo, Xos, Xoi^Qhh, Xos, Xos, Ur^Vud, Tb^Tf, Ur^Edt, Cud, 2 Kud, Cud, Ur, Tb^Tf, Ur^Vud, Xos, Xos^Qhh, Xoc, Xoc, Xoc, Xoc, Xoc, Xoc, Xoi, Xu, Xu, Xu, Xu, Xu, Xoc, Xoc, Xu, Xoc, Xoc
Xoc, Xoc, Xoc, Xos, Xos, Iwo, Xos, Xos, Xor^Qhh, Xor, Xoc, Xos, Tb^Tf, Ur, Ur, Cud, Ur, Ur, Tb^Tf, Xos, Xoc, Xor^Qhh, Xoc, Xoc, Xoc, Xoc, Xoc, Xof, Xu, Xu, Xu, Xu, Xu, Xoc, Xu, Xu, Xoc, Xoc, Xu
Xoc, Xoc, Xoc, Xor, Xoc, Xos, Xoc, Xoc, Xor^Qhh, Xor, Xoc, Xos, Xos, Xos, Xos, Ur, Uh, Uh, Xu, Xos, Xoc, Xoi^Qhh, Xoc, Xoc, Xoc, Xoc, Xoi, Xu, Xoc, Xu, Xu, Xu, Xu, Xu, Xu, Xu, Xoc, Xoc, Xoc
Xoi, Xoc, Xoc, Xoc, Xor, Xoc, Xoc, Xoc, Xos^Qhh, Xos, Xos, Xos, Xoc, Xoc, Xoc, Ur, Uh, Uh, Xu, Xu, Xoc, Xos^Qhh, Xos, Xos, Xos, Xoc, Xoc, Xoc, Xoc, Xoc, Xoc, Xoc, Xoc, Xoc, Xoc, Xoc, Xoc, Xoc, Xoc
